
; 2x3-Birtiests-2-2-247
#####
# $.#
#@$.#
#####

