
; 2x4-Pawnerespoil-4-2-821
######
# $ .#
#@$ .#
######

