Author: Fuzitoo
Set: Sample

########
#   #  #
#  $   #
##$##$ #
# @#  ##
#   ...#
########
Title: Go Through
