Title: sunshine001
Author: Eric Sunshine <sunshine@sunshineco.com>
Date: 2002/04/28
Comment: Overlapping crate-path demonstration.
   ####
   #  #
 ###  #
 #.#  #
 # # #####
##   #   #
#        #
#  # #####
#  # #
####$#
   #@#
   ###
