Let's Logic Collection ID: 380
Title: Labyrinth of Agony
Author: Marko Dzekic
Description: Number of levels: 12

____#################____
____#---*---*---*---#____
__###--*.--*.*--.**-###__
__#-----$-*-$-*-$-----#__
###-##-###########-##-###
#---#---*-*-*-*-*-*-#---#
#-*---#-#---#---#-#-----#
#-*-#-----#####-----#-*-#
#*.$#-#-#---#---#-#*#$.*#
#---#-*-*-*-*-*-*---#---#
#--*#*-#-*##$##*-#-*#*--#
#-*-#--#--#.--#--#--#-*-#
#*.$#*###*$--$.*###*#$.*#
#-*-#--#--#-..#--#--#-*-#
#--*#*-#-*##$##*-#-*#*--#
#---#-$---*-*-*-*-.-#---#
#*.$#.#-#*--#---#-#$#$.*#
#-*-#--@--#####-----#-*-#
#-*--$#-#---#---#-#.--*-#
#---#-.-*-*-*-*-*-$-#---#
###-##-###########-##-###
__#-----$-*-$-*-$-----#__
__###-**.--*.*--.*--###__
____#---*---*---*---#____
____#################____
ID: 27368
Title: Avril Lavigne
Author: Marko Dzekic

____#################____
____#---*---*---*---#____
__###--*.--*.*--.**-###__
__#-----$-*-$-*-$-----#__
###-##-###########-##-###
#---#-$-$-*-*-*-.-.-#---#
#-*---#-#.--#--$#-#$--*-#
#-*-#-----#####--@--#-*-#
#*.$#.#-#$--#--.#-#*#$.*#
#---#---.-*-*-*-$---#---#
#--*#*-#-*##$##*-#-*#*--#
#-*-#--#--#.-.#--#--#-*-#
#*.$#*###*$-#-$*###*#$.*#
#-*-#--#--#.--#--#--#-*-#
#--*#*-#-*##-##*-#-*#*--#
#---#---*-*-*-*-.-$-#---#
#*.$#*#-#---#--$#-#.#$.*#
#-*-#-----#####-----#-*-#
#----$#-#---#--.#-#---*-#
#---#-.-*-*-*-*-$-*-#---#
###-##-###########-##-###
__#-----$-*-$-*-$-----#__
__###-**.--*.*--.*--###__
____#---*---*---*---#____
____#################____
ID: 27369
Title: Mandy Moore
Author: Marko Dzekic

____#################____
____#---*---*---*---#____
__###-**.--*.*--.**-###__
__#-----$-*-$-*-$-----#__
###-##-###########-##-###
#---#-.-*-*-*-*-*-$-#---#
#-*--$#-#---#---#-#.----#
#-*-#--@--#####-----#-*-#
#*.$#.#-#---#--$#-#.#$.*#
#---#-$-.-*-*-*-.-$-#---#
#--*#*-#-*##-##*-#-*#*--#
#-*-#--#--#.--#--#--#-*-#
#*.$#*###*$-#-$*###*#$.*#
#-*-#--#--#.-.#--#--#-*-#
#--*#*-#-*##$##*-#-*#*--#
#---#-$-.-*-*-*-$-.-#---#
#*.$#-#-#$--#--.#-#$#$.*#
#-*-#-----#####-----#-*-#
#----*#-#.--#---#-#$--*-#
#---#---$-*-*-*-*-.-#---#
###-##-###########-##-###
__#-----$-*-$-*-$-----#__
__###-**.--*.*--.*--###__
____#---*---*---*---#____
____#################____
ID: 27370
Title: Shakira
Author: Marko Dzekic

____#################____
____#---*---*---*---#____
__###-**.--*.*--.*--###__
__#-----$-*-$-*-$-----#__
###-##-###########-##-###
#---#-*-*-*-*-*-*---#---#
#-----#-#---#---#-#*--*-#
#-*-#-----#####-----#-*-#
#*.$#*#-#$--#--*#-#.#$.*#
#---#---.-*-*-*---$-#---#
#--*#*-#-*##$##*-#-*#*--#
#-*-#--#--#--.#--#--#-*-#
#*.$#*###*--#-$*###*#$.*#
#-*-#--#--#.-.#--#--#-*-#
#--*#*-#-*##$##*-#-*#*--#
#---#---$-*-*-*-.-*-#---#
#*.$#*#-#.--#---#-#-#$.*#
#-*-#--@--#####-----#-*-#
#-*---#-#---#---#-#$----#
#---#-$-*-*-*-*-*-.-#---#
###-##-###########-##-###
__#-----$-*-$-*-$-----#__
__###-**.--*.*--.**-###__
____#---*---*---*---#____
____#################____
ID: 27371
Title: Britney Spears
Author: Marko Dzekic

____#################____
____#---*---*---*---#____
__###--*.--*.*--.**-###__
__#-----*-$-$-*-$-----#__
###-##-###########-##-###
#---#-*-*-*-*-*-*---#---#
#-*---#-#---#---#-#*--*-#
#-*-#-----#####--@--#-*-#
#*.$#*#-#.--#--*#-#$#$.*#
#---#---$-*-*-*---.-#---#
#--*#*-#-*##$##*-#-*#*--#
#-*-#--#--#--.#--#--#-*-#
#*.$#*###*$-#-$*###*#$.*#
#-*-#--#--#.-.#--#--#-*-#
#--*#*-#-*##-##*-#-*#*--#
#---#---.-*-*-*-*-$-#---#
#*.$#*#-#$--#---#-#.#$.*#
#-*-#-----#####-----#-*-#
#-*--*#-#---#---#-#-----#
#---#---*-*-*-*-*---#---#
###-##-###########-##-###
__#-----$-*-$-*-$-----#__
__###--*.--*.*--.**-###__
____#---*---*---*---#____
____#################____
ID: 27372
Title: Lindsay Lohan
Author: Marko Dzekic

____#################____
____#---*---*---*---#____
__###--*.--*.*--.**-###__
__#-----$-*-$-*-$-----#__
###-##-###########-##-###
#---#-*-*-*-*-*-.-$-#---#
#-*---#-#---#--$#-#.--*-#
#-*-#-----#####-----#-*-#
#*.$#.#-#*--#--.#-#$#$.*#
#---#-$---*-*-*---.-#---#
#--*#*-#-*##-##*-#-*#*--#
#-*-#--#--#.--#--#--#-*-#
#*.$#*###*$-#-$*###*#$.*#
#-*-#--#--#.-.#--#--#-*-#
#--*#*-#-*##$##*-#-*#*--#
#---#---*-*-*-*---*-#---#
#*.$#*#-#---#--*#-#-#$.*#
#-*-#--@--#####-----#-*-#
#----$#-#---#---#-#---*-#
#---#-.-*-*-*-*-*-$-#---#
###-##-###########-##-###
__#-----$-*-$-*-$-----#__
__###-**.--*.*--.*--###__
____#---*---*---*---#____
____#################____
ID: 27373
Title: Rihanna
Author: Marko Dzekic

____#################____
____#---*---*---*---#____
__###-**.--*.*--.**-###__
__#-----$-*-$-*-$-----#__
###-##-###########-##-###
#---#---*-*-*-*-$-.-#---#
#----$#-#---#--.#-#$----#
#-*-#-----#####-----#-*-#
#*.$#$#-#.--#--*#-#*#*.*#
#---#-.-$-*-*-*-----#---#
#--*#*-#-*##$##*-#-*#$--#
#-*-#--#--#--.#--#--#-*-#
#*.$#*###*--#-$*###*#$.*#
#-*-#--#--#.-.#--#--#-*-#
#--*#*-#-*##$##*-#-*#*--#
#---#-$-*-*-*-*-.---#---#
#*.$#.#-#---#--$#-#.#$.*#
#-*-#--@--#####-----#-*-#
#-*--.#-#$--#---#-#---*-#
#---#-$-.-*-*-*-*-*-#---#
###-##-###########-##-###
__#-----$-*-$-$-*-----#__
__###-**.--*.*--.*--###__
____#---*---*---*---#____
____#################____
ID: 27374
Title: Hilary Duff
Author: Marko Dzekic

____#############################____
____#---*---*---*---*---*---*---#____
__###--*.--*.*--.*--.--*.*--.**-###__
__#-----$-*-$-*-$---$-*-$-*-$-----#__
###-##-##########-############-##-###
#---#-.-*-*-*-*-----*-*-*-*-*-$-#---#
#-*--$#-#---#--*##-##---#---#-#.----#
#-*-#-----#####-------#####-----#-*-#
#*.$#.#-#*--#--*#-#-#*--#--*#-#-#$.*#
#---#-$---*-*-*---*---*-*-*---.-#---#
#--*#*-#-*##-##*-#-#-*##-##*-#-*#*--#
#-*-#--#--#.--#--#-#--#--.#--#--#-*-#
#*.$#*###*$-#-$*#####*$-#-$*###*#$.*#
#-*-#--#--#.-.#--#-#--#.-.#--#--#-*-#
#--*#*-#-*##$##*-#-#-*##$##*-#-*#*--#
#---#---*-*-*-*-*-*---*-*-*-*---#---#
#*.$#*#-#---#---#-#-#*--#---#-#*#$.*#
#-*-#-----#####-------#####--@--#-*-#
#-----#-#*--#---##-##---#--*#-#$--*-#
#---#-*---*-*-*-*---*-*-*-*-----#---#
###-##-############-##########-##-###
__#-----$-*-$-*-$---$-*-$-*-$-----#__
__###-**.--*.*--.*--.--*.*--.**-###__
____#---*---*---*---*---*---*---#____
____#############################____
ID: 27375
Title: Jessica Simpson
Author: Marko Dzekic

____#############################____
____#---*---*---*---*---*---*---#____
__###-**.--*.*--.*--.--*.*--.**-###__
__#-----$-*-$-*-$---$-*-$-*-$-----#__
###-##-##########-############-##-###
#---#---.-*-*-*-*---$-*-*-*-*-*-#---#
#-*--*#-#---#---##-##.--#---#-#---*-#
#-*-#-----#####-------#####--@--#-*-#
#*.$#*#-#---#--.#-#-#---#--*#-#$#$.*#
#---#---*-*-*-*-$-*-*-*-*-*---.-#---#
#--*#*-#-*##$##*-#-#-*##$##*-#-*#*--#
#-*-#--#--#--.#--#-#--#.-.#--#--#-*-#
#*.$#*###*$-#--*#####*$-#-$*###*#$.*#
#-*-#--#--#.-.#--#-#--#.--#--#--#-*-#
#--$#*-#-*##$##*-#-#-*##-##*-#-*#*--#
#---#-$---*-*-*-*-*-.-*-*-*-.-$-#---#
#*.*#-#-#*--#---#-#-#$--#--$#-#.#$.*#
#-*-#-----#####-------#####-----#-*-#
#-----#-#---#--$##-##*--#--.#-#-----#
#---#-*-*-*-*-*-.-----*-*-*-$-*-#---#
###-##-############-##########-##-###
__#-----$-*-$-*-$---$-*-$-*-$-----#__
__###--*.--*.*--.*--.--*.*--.**-###__
____#---*---*---*---*---*---*---#____
____#############################____
ID: 27376
Title: Kelly Clarkson
Author: Marko Dzekic

____###############################____
____#---*---*---*-----*---*---*---#____
__###-**.--*.*--.**--*.--*.*--.**-###__
__#-----$-*-$-*-$-----$-*-$-*-$-----#__
###-##-###########-#############-##-###
#---#-*-.-*-*-*-*-----$-*-*-*-$-.-#---#
#-*---#-#$--#---###-###.--#--.#-#$--*-#
#-*-#-----#####---------#####--@--#-*-#
#*.$#-#-#.--#---#-###-#*--#--$#-#*#$.*#
#---#-*-$-*-*-*-*-.*.---*-*-*-.---#---#
#--*#*-#-*##$##*-#$-$#-*##$##*-#-*#*--#
#-*-#--#--#.-.#--#-$-#--#--.#--#--#-*-#
#*.$#*###*$-#--*##.--##*$-#--*###*#$.*#
#-*-#--#--#.--#--#$-$#--#.-.#--#--#-*-#
#--*#*-#-*##$##*-#--.#-*##$##*-#-*#$--#
#---#---$-*-*-*-*--*.-*-*-*-*-.---#---#
#*.$#*#-#.--#---#.###-#---#--$#-#*#*.*#
#-*-#-#---#####----$--.-#####---#-#-*-#
#---#-#-#.$---$.#--.#-#.-$-$--#-#-----#
#---#---#*---$-*#-.$.-#*--*--*#---#---#
#-*---#-#.$-$-..#$$*$$#..$-$-.#-#-#-*-#
#-*-#-#---#####-.--$----#####---#-#-*-#
#*.$#*#-#$--#---#-###.#*--#--*#-#.#$.*#
#---#---.-*-*-*-*-.*----*-*-*---$-#---#
#--*#*-#-*##-##*-#.$-#-*##$##*-#-*#*--#
#-*-#--#--#.--#--#$-$#--#.-.#--#--#-*-#
#*.$#*###*$-#-$*##-.-##*$-#-$*###*#$.*#
#-*-#--#--#.-.#--#---#--#.--#--#--#-*-#
#--*#*-#-*##$##*-#$-$#-*##-##*-#-*#$--#
#---#-$-.-*-*-*---.*.---*-*-*-----#---#
#*.$#-#-#$--#--*#-###-#*--#--.#-#*#*.*#
#-*-#-----#####---------#####-----#-*-#
#----*#-#.--#---###-###$--#---#-#*----#
#---#---$-*-*-*-*-----.-*-*-*-*---#---#
###-##-#############-###########-##-###
__#-----$-*-$-*-$-----$-*-$-*-------#__
__###-**.--*.*--.*--**.--*.*--**--###__
____#---*---*---*-----*---*---*---#____
____###############################____
ID: 27377
Title: Christina Aguilera
Author: Marko Dzekic

____###############################____
____#---*---*---*-----*---*---*---#____
__###-**.--*.*--.*--**.--*.*--.*--###__
__#-----$-*-$-*-$-----$-*-$-*-$-----#__
###-##-###########-#############-##-###
#---#-*-.-*-*-*-*-----$-*-*-*-$-.-#---#
#-*---#-#$--#---###-###.--#--.#-#$----#
#-*-#-----#####---------#####-----#-*-#
#*.$#-#-#.--#---#-###-#*--#--$#-#*#$.*#
#---#-*-$-*-*-*-*--*----*-*-*-.---#---#
#--*#*-#-*##$##*-##$##-*##$##*-#-*#*--#
#-*-#--#--#.-.#--#-.-#--#.--#--#--#-*-#
#*.$#*###*$-#--*#--#--#*--#-$*###*#$.*#
#-*-#--#--#.--#--#-.-#--#.-.#--#--#-*-#
#--$#*-#-*##$##*-##$##-*##$##*-#-*#*--#
#---#---$-*-*-*-*--*--*-*-*-*-.---#---#
#*.*#*#-#.--#---#-###-#---#--$#-#*#$.*#
#-*-#-#---##-##----.--.-##-##---#-#-*-#
#---#-#-#-#---#-#$$.$$#-----#-#-#-----#
#---#---#*$.#.$*#--..-#*#-#$#*#---#---#
#-*---#-#-#---#-#$$.$$#.#---.-#-#-#-*-#
#-*-#-#---##-##----.----##-##---#-#-*-#
#*.$#*#-#$--#---#-###-#*--#--*#-#.#$.*#
#---#---.-*-*-*-*--*----*-*-*---$-#---#
#--*#*-#-*##-##*-##$##-*##$##*-#-*#*--#
#-*-#--#--#.-.#--#-.-#--#.-.#--#--#-*-#
#*.$#*###*$-#-$*#--#--#*$-#-$*###*#$.*#
#-*-#--#--#--.#--#-.-#--#.--#--#--#-*-#
#--$#*-#-*##$##*-##$##-*##-##*-#-*#*--#
#---#-$-.-*-*-*----*----*-*-*-----#---#
#*.*#-#-#$--#--*#-###-#*--#--.#-#*#$.*#
#-*-#--@--#####---------#####-----#-*-#
#----*#-#.--#---###-###$--#---#-#*--*-#
#---#---$-*-*-*-*-----.-*-*-*-*---#---#
###-##-#############-###########-##-###
__#-----$-*-$-$-*-----$-*-$-$-*-----#__
__###-**.--*.*--.*--**.--*.*--.*--###__
____#---*---*---*-----*---*---*---#____
____###############################____
ID: 27378
Title: Christina Aguilera Divine
Author: Marko Dzekic

____###############################____
____#---*---*---*-----*---*---*---#____
__###-**.--*.*--.**--*.--*.*--.**-###__
__#-----$-*-$-*-$-----$-*-$-*-$-----#__
###-##-###########-#############-##-###
#---#-*-.-*-*-*-*-----$-*-*-*-$-.-#---#
#-*---#-#$--#---###-###.--#--.#-#$--*-#
#-*-#--@--#####---------#####-----#-*-#
#*.$#-#-#.--#---#-###-#*--#--$#-#*#$.*#
#---#-*-$-*-*-*-*--*----*-*-*-.---#---#
#--*#*-#-*##$##*-###.#-*##$##*-#-*#*--#
#-*-#--#--#.-.#--#-$-#--#.--#--#--#-*-#
#*.$#*###*$-#--*#--#--#*--#-$*###*#$.*#
#-*-#--#--#.--#--#---#--#.-.#--#--#-*-#
#--*#*-#-*##$##*-#-###-*##$##*-#-*#$--#
#---#---$-*-*-*-*--*--*-*-*-*-.---#---#
#*.$#*#-#.--#---#-###-#---#--$#-#*#*.*#
#-*-#-#---##-##---$.$---##-##---#-#-*-#
#---#-#-#-#---#-#-----#-#---#-#-#-----#
#---#---#*$.#.$*#.*#*.#*$.#.$*#---#---#
#-*---#-#-#---#-#-----#-#---#-#-#-#-*-#
#-*-#-#---##-##---$.$---##-##---#-#-*-#
#*.$#*#-#$--#---#-###-#*--#--*#-#.#$.*#
#---#---.-*-*-*-*--*----*-*-*---$-#---#
#--*#*-#-*##-##*-##$##-*##$##*-#-*#*--#
#-*-#--#--#.-.#--#-.-#--#.-.#--#--#-*-#
#*.$#*###*$-#-$*#--#--#*$-#-$*###*#$.*#
#-*-#--#--#--.#--#-.-#--#.--#--#--#-*-#
#--*#*-#-*##$##*-##$##-*##-##*-#-*#$--#
#---#-$-.-*-*-*----*----*-*-*-----#---#
#*.$#-#-#$--#--*#-###-#*--#--.#-#*#*.*#
#-*-#-----#####---------#####-----#-*-#
#----*#-#.--#---###-###$--#---#-#*----#
#---#---$-*-*-*-*-----.-*-*-*-*---#---#
###-##-#############-###########-##-###
__#-----$-*-$-*-$-----$-*-$-*-$-----#__
__###-**.--*.*--.*--**.--*.*--.*--###__
____#---*---*---*-----*---*---*---#____
____###############################____
ID: 27379
Title: Christina Aguilera Perfect
Author: Marko Dzekic