Let's Logic Collection ID: 378
Title: Labyrinth
Author: Marko Dzekic
Description: Number of levels: 10

____#################____
____#---*---*---*---#____
__###--*.--*.*--.**-###__
__#-----$-*-$-*-$-----#__
###-##-###########-##-###
#---#-$-*-*-*-*-.-*-#---#
#-*---#-#---#---#-#-----#
#-*-#$----#####----$#-*-#
#*.$#.#-#---#---#-#.#$.*#
#---#---*-*-*-*-*---#---#
#--*#*-#-*##-##*-#-*#*--#
#-*-#--#--#--.#--#--#-*-#
#*.$#*###*$-#-$*###*#$.*#
#-*-#--#--#.-.#--#--#-*-#
#--*#*-#-*##$##*-#-.#*--#
#---#-.-.-*-*-*-$-$-#---#
#*.$#$#-#$--#--.#-#*#$.*#
#-*-#--@--#####-----#-*-#
#-*--.#-#.--#--$#-#$--*-#
#---#-$-$-*-*-*-.-.-#---#
###-##-###########-##-###
__#-----$-*-$-*-$-----#__
__###-**.--*.*--.*--###__
____#---*---*---*---#____
____#################____
ID: 27312
Title: Calliope
Author: Marko Dzekic

____#################____
____#---*---*---*---#____
__###--*.--*.*--.**-###__
__#-----$-*-$-*-$-----#__
###-##-###########-##-###
#---#-$-*-*-*-*-.-*-#---#
#-----#-#---#---#-#---*-#
#-*-#$----#####----$#-*-#
#*.*#.#-#---#---#-#.#$.*#
#---#---*-*-*-*-*---#---#
#--$#*-#-*##$##*-#-*#*--#
#-*-#--#--#.--#--#--#-*-#
#*.$#*###*$-#--*###*#$.*#
#-*-#--#--#.-.#--#--#-*-#
#--*#*-#-*##$##*-#-.#*--#
#---#-.-.-*-*-*-$-$-#---#
#*.$#$#-#$--#--.#-#*#$.*#
#-*-#--@--#####-----#-*-#
#-*--.#-#.--#--$#-#$--*-#
#---#-$-$-*-*-*-.-.-#---#
###-##-###########-##-###
__#-----$-*-$-*-$-----#__
__###-**.--*.*--.*--###__
____#---*---*---*---#____
____#################____
ID: 27313
Title: Clio
Author: Marko Dzekic

____#################____
____#---*---*---*---#____
__###-**.--*.*--.**-###__
__#-----$-*-$-*-$-----#__
###-##-###########-##-###
#---#-$-*-*-*-*-.-*-#---#
#-----#-#---#---#-#-----#
#-*-#$----#####----$#-*-#
#*.*#.#-#---#---#-#.#$.*#
#---#---*-*-*-*-*---#---#
#--$#*-#-*##$##*-#-*#*--#
#-*-#--#--#.-.#--#--#-*-#
#*.$#*###*$-#-$*###*#$.*#
#-*-#--#--#--.#--#--#-*-#
#--*#*-#-*##-##*-#-.#*--#
#---#-.-.-*-*-*-$-$-#---#
#*.$#$#-#$--#--.#-#*#$.*#
#-*-#--@--#####-----#-*-#
#-*--.#-#.--#--$#-#$--*-#
#---#-$-$-*-*-*-.-.-#---#
###-##-###########-##-###
__#-----$-*-$-*-$-----#__
__###-**.--*.*--.*--###__
____#---*---*---*---#____
____#################____
ID: 27314
Title: Erato
Author: Marko Dzekic

____#################____
____#---*---*---*---#____
__###--*.--*.*--.**-###__
__#-----*-$-$-*-$-----#__
###-##-###########-##-###
#---#-$-*-*-*-*-.$.-#---#
#-----#-#---#---#-#---*-#
#-*-#$----#####----$#-*-#
#*.$#.#-#---#---#-#.#$.*#
#---#---*-*-*-*-*---#---#
#--*#*-#-*##$##*-#-*#*--#
#-*-#--#--#--.#--#--#-*-#
#*.$#*###*--#-$*###*#$.*#
#-*-#--#--#.-.#--#--#-*-#
#--*#*-#-*##$##*-#-.#*--#
#---#-.-.-*-*-*-$-$-#---#
#*.$#$#-#$--#--.#-#*#$.*#
#-*-#--@--#####-----#-*-#
#-*--.#-#.--#--$#-#$----#
#---#-$-$-*-*-*-.-.-#---#
###-##-###########-##-###
__#-----$-*-$-*-$-----#__
__###-**.--*.*--.**-###__
____#---*---*---*---#____
____#################____
ID: 27315
Title: Euterpe
Author: Marko Dzekic

____#################____
____#---*---*---*---#____
__###--*.--*.*--.**-###__
__#-----$-*-$-*-$-----#__
###-##-###########-##-###
#---#-$-*-*-*-*-.-*-#---#
#-*---#-#---#---#-#-----#
#-*-#$----#####----$#-*-#
#*.$#.#-#---#---#-#.#$.*#
#---#---*-*-*-*-*---#---#
#--*#*-#-*##$##*-#-*#*--#
#-*-#--#--#*--#--#--#-*-#
#*.$#*###*$-$..*###*#$.*#
#-*-#--#--#.-.#--#--#-*-#
#--*#*-#-*##$##*-#-.#*--#
#---#-.-.-*-*-*-$-$-#---#
#*.$#$#-#$--#--.#-#*#$.*#
#-*-#--@--#####-----#-*-#
#-*--.#-#.--#--$#-#$--*-#
#---#-$-$-*-*-*-.-.-#---#
###-##-###########-##-###
__#-----$-*-$-*-$-----#__
__###-**.--*.*--.*--###__
____#---*---*---*---#____
____#################____
ID: 27316
Title: Melpomene
Author: Marko Dzekic

____#################____
____#---*---*---*---#____
__###-**.--*.*--.**-###__
__#-----$-*-$-*-$-----#__
###-##-###########-##-###
#---#-$-*-*-*-*-.-*-#---#
#-----#-#---#---#-#-----#
#-*-#$----#####----$#-*-#
#*.*#.#-#---#---#-#.#$.*#
#---#---*-*-*-*-*---#---#
#--$#*-#-*#####*-#-*#*--#
#-*-#--#--#-..#--#--#-*-#
#*.$#*###*$$$--*###*#$.*#
#-*-#--#--#.-.#--#--#-*-#
#--*#*-#-*##$##*-#-.#*--#
#---#-.-.-*-*-*-$-$-#---#
#*.$#$#-#$--#--.#-#*#$.*#
#-*-#--@--#####-----#-*-#
#-*--.#-#.--#--$#-#$--*-#
#---#-$-$-*-*-*-.-.-#---#
###-##-###########-##-###
__#-----$-*-$-*-$-----#__
__###-**.--*.*--.*--###__
____#---*---*---*---#____
____#################____
ID: 27317
Title: Polyhymnia
Author: Marko Dzekic

____#################____
____#---*---*---*---#____
__###-***--***--**--###__
__#-------*-----*-----#__
###-##-###########-##-###
#---#---*-*-*-*-*-*-#---#
#-*---#-#---#---#-#---*-#
#-*-#-----#####-----#-*-#
#**-#*#-#---#---#-#*#-**#
#---#---*-*-*-*-*---#---#
#--*#*-#-*##-##*-#-*#*--#
#-*-#--#--#.--#--#--#-*-#
#**-#*###*$-#-$*###*#-**#
#-*-#--#--#.-.#--#--#-*-#
#--*#*-#-*##$##*-#-*#*--#
#---#-*-*-*-*-*-----#---#
#**-#-#-#---#--*#-#*#-**#
#-*-#--@--#####-----#-*-#
#----*#-#*--#---#-#---*-#
#---#-----*-*-*-*-*-#---#
###-##-###########-##-###
__#-------*---*-------#__
__###-***--***--**--###__
____#---*---*---*---#____
____#################____
ID: 27318
Title: Terpsichore
Author: Marko Dzekic

____#################____
____#---*---*---*---#____
__###-***--***--***-###__
__#-------*---*-------#__
###-##-###########-##-###
#---#---*-*-*-*-*-*-#---#
#-*---#-#---#---#-#-----#
#-*-#-----#####-----#-*-#
#**-#*#-#---#---#-#*#-**#
#---#---*-*-*-*-*---#---#
#--*#*-#-*##$##*-#-*#*--#
#-*-#--#--#.-.#--#--#-*-#
#**-#*###*$-#--*###*#-**#
#-*-#--#--#--.#--#--#-*-#
#--*#*-#-*##$##*-#-*#*--#
#---#-*-*-*-*-*-----#---#
#**-#-#-#---#--*#-#*#-**#
#-*-#--@--#####-----#-*-#
#----*#-#*--#---#-#---*-#
#---#-----*-*-*-*-*-#---#
###-##-###########-##-###
__#-------*---*-------#__
__###-***--***--**--###__
____#---*---*---*---#____
____#################____
ID: 27319
Title: Thalia
Author: Marko Dzekic

____#################____
____#---*---*---*---#____
__###-***--***--**--###__
__#-------*---*-------#__
###-##-###########-##-###
#---#---*-*-*-*-*-*-#---#
#-----#-#---#---#-#---*-#
#-*-#-----#####-----#-*-#
#**-#*#-#---#---#-#*#-**#
#---#---*-*-*-*-*---#---#
#--*#*-#-*##$##*-#-*#*--#
#-*-#--#--#--.#--#--#-*-#
#**-#*###*--#-$*###*#-**#
#-*-#--#--#.-.#--#--#-*-#
#--*#*-#-*##$##*-#-*#*--#
#---#-*-*-*-*-*-----#---#
#**-#-#-#---#--*#-#*#-**#
#-*-#--@--#####-----#-*-#
#-*--*#-#*--#---#-#-----#
#---#-----*-*-*-*-*-#---#
###-##-###########-##-###
__#-------*---*-------#__
__###-***--***--***-###__
____#---*---*---*---#____
____#################____
ID: 27320
Title: Urania
Author: Marko Dzekic

____#################____
____#---*---*---*---#____
__###-***--***--**--###__
__#-------*---*-------#__
###-##-###########-##-###
#---#---*-*-*-*-*-*-#---#
#-*---#-#---#---#-#---*-#
#-*-#-----#####-----#-*-#
#**-#*#-#---#---#-#*#-**#
#---#---*-*-*-*-*---#---#
#--*#*-#-*##$##*-#-*#*--#
#-*-#--#--#.-.#--#--#-*-#
#**-#*###*$-#-$*###*#-**#
#-*-#--#--#.--#--#--#-*-#
#---#*-#-*##-##*-#-*#*--#
#---#-*-*-*-*-*-----#---#
#***#-#-#---#--*#-#*#-**#
#-*-#--@--#####-----#-*-#
#----*#-#*--#---#-#-----#
#---#-----*-*-*-*-*-#---#
###-##-###########-##-###
__#-------*---*-------#__
__###-***--***--***-###__
____#---*---*---*---#____
____#################____
ID: 27321
Title: Mnemosine
Author: Marko Dzekic