Let's Logic Collection ID: 652
Title: Lost Rooms
Author: Bobby
Description: Includes those levels, that were not included in Bobby's "Rooms", but are a logical derivate to solve them.

It is Not allowed to make this collection a part of any payable Sokoban program, such as Bjorn Kallmark's sokoban etc. You can make it a part of any freeware programs though.



######################################________________________________
##-------#-------#-------#--------+$-#________________________________
#--#-###---#-###---#-###---#-######--#________________________________
#-#--*--###--*--###--*--###--*--###--#________________________________
#-#---#-###---#-###---#-###---#-###-*#________________________________
#--####-#--####-#--####-#--####-#--#-#________________________________
##-#--#----#--#----#--#----#--#----#-#________________________________
#--#----#*-#----#*-#----#*-#----#*-#-#________________________________
#-##-*###--#-*###--#-*###--#-*###--#-#________________________________
#--##-#--*-##-#--*-##-#--*-##-#--*-#-#________________________________
##-#--#-#--#--#-#--#--#-#--#--#-#--#-#________________________________
#--#-##-####-##-####-##-####-##-####-#________________________________
#-##-#-----#-#-----#-#-----#-#-----#-#________________________________
#-##--*-*--#--*-*--#--*-*--#--*-*--#-#________________________________
#--#-####-##-####-##-####-##-####-##-#________________________________
##-#-####----####----####----####----#________________________________
##-#-#################################################################
#--#-####----####----####----####----####----####----####----####---##
#-##-####-##-####-##-####-##-####-##-####-##-####-##-####-##-####-#--#
#-#--*-*--#--*-*--#--*-*--#--*-*--#--*-*--#--*-*--#--*-*--#--*-*--##-#
#-#-----#-#-----#-#-----#-#-----#-#-----#-#-----#-#-----#-#-----#-##-#
#-####-##-####-##-####-##-####-##-####-##-####-##-####-##-####-##-#--#
#-#--#-#--#--#-#--#--#-#--#--#-#--#--#-#--#--#-#--#--#-#--#--#-#--#-##
#-#-*--#-##-*--#-##-*--#-##-*--#-##-*--#-##-*--#-##-*--#-##-*--#-##--#
#-#--###*-#--###*-#--###*-#--###*-#--###*-#--###*-#--###*-#--###*-##-#
#-#-*#----#-*#----#-*#----#-*#----#-*#----#-*#----#-*#----#-*#----#--#
#-#----#--#----#--#----#--#----#--#----#--#----#--#----#--#----#--#-##
#-#--#-####--#-####--#-####--#-####--#-####--#-####--#-####--#-####--#
#-####-#---###-#---###-#---###-#---###-#---###-#---###-#---###-#---#-#
#-####--*--###--*--###--*--###--*--###--*--###--*--###--*--###--*--#-#
#-#---###-#---###-#---###-#---###-#---###-#---###-#---###-#---###-#--#
#---#-------#-------#-------#-------#-------#-------#-------#-------##
######################################################################
ID: 90735
Title: 12 Rooms
Author: Bobby

######################################################________________
##-------#-------#-------#-------#-------#--------+$-#________________
#--#-###---#-###---#-###---#-###---#-###---#-######--#________________
#-#--*--###--*--###--*--###--*--###--*--###--*--###--#________________
#-#---#-###---#-###---#-###---#-###---#-###---#-###-*#________________
#--####-#--####-#--####-#--####-#--####-#--####-#--#-#________________
##-#--#----#--#----#--#----#--#----#--#----#--#----#-#________________
#--#----#*-#----#*-#----#*-#----#*-#----#*-#----#*-#-#________________
#-##-*###--#-*###--#-*###--#-*###--#-*###--#-*###--#-#________________
#--##-#--*-##-#--*-##-#--*-##-#--*-##-#--*-##-#--*-#-#________________
##-#--#-#--#--#-#--#--#-#--#--#-#--#--#-#--#--#-#--#-#________________
#--#-##-####-##-####-##-####-##-####-##-####-##-####-#________________
#-##-#-----#-#-----#-#-----#-#-----#-#-----#-#-----#-#________________
#-##--*-*--#--*-*--#--*-*--#--*-*--#--*-*--#--*-*--#-#________________
#--#-####-##-####-##-####-##-####-##-####-##-####-##-#________________
##-#-####----####----####----####----####----####----#________________
##-#-#################################################################
#--#-####----####----####----####----####----####----####----####---##
#-##-####-##-####-##-####-##-####-##-####-##-####-##-####-##-####-#--#
#-#--*-*--#--*-*--#--*-*--#--*-*--#--*-*--#--*-*--#--*-*--#--*-*--##-#
#-#-----#-#-----#-#-----#-#-----#-#-----#-#-----#-#-----#-#-----#-##-#
#-####-##-####-##-####-##-####-##-####-##-####-##-####-##-####-##-#--#
#-#--#-#--#--#-#--#--#-#--#--#-#--#--#-#--#--#-#--#--#-#--#--#-#--#-##
#-#-*--#-##-*--#-##-*--#-##-*--#-##-*--#-##-*--#-##-*--#-##-*--#-##--#
#-#--###*-#--###*-#--###*-#--###*-#--###*-#--###*-#--###*-#--###*-##-#
#-#-*#----#-*#----#-*#----#-*#----#-*#----#-*#----#-*#----#-*#----#--#
#-#----#--#----#--#----#--#----#--#----#--#----#--#----#--#----#--#-##
#-#--#-####--#-####--#-####--#-####--#-####--#-####--#-####--#-####--#
#-####-#---###-#---###-#---###-#---###-#---###-#---###-#---###-#---#-#
#-####--*--###--*--###--*--###--*--###--*--###--*--###--*--###--*--#-#
#-#---###-#---###-#---###-#---###-#---###-#---###-#---###-#---###-#--#
#---#-------#-------#-------#-------#-------#-------#-------#-------##
######################################################################
ID: 90736
Title: 14 Rooms
Author: Bobby

##############################################################________
##-------#-------#-------#-------#-------#-------#--------+$-#________
#--#-###---#-###---#-###---#-###---#-###---#-###---#-######--#________
#-#--*--###--*--###--*--###--*--###--*--###--*--###--*--###--#________
#-#---#-###---#-###---#-###---#-###---#-###---#-###---#-###-*#________
#--####-#--####-#--####-#--####-#--####-#--####-#--####-#--#-#________
##-#--#----#--#----#--#----#--#----#--#----#--#----#--#----#-#________
#--#----#*-#----#*-#----#*-#----#*-#----#*-#----#*-#----#*-#-#________
#-##-*###--#-*###--#-*###--#-*###--#-*###--#-*###--#-*###--#-#________
#--##-#--*-##-#--*-##-#--*-##-#--*-##-#--*-##-#--*-##-#--*-#-#________
##-#--#-#--#--#-#--#--#-#--#--#-#--#--#-#--#--#-#--#--#-#--#-#________
#--#-##-####-##-####-##-####-##-####-##-####-##-####-##-####-#________
#-##-#-----#-#-----#-#-----#-#-----#-#-----#-#-----#-#-----#-#________
#-##--*-*--#--*-*--#--*-*--#--*-*--#--*-*--#--*-*--#--*-*--#-#________
#--#-####-##-####-##-####-##-####-##-####-##-####-##-####-##-#________
##-#-####----####----####----####----####----####----####----#________
##-#-#################################################################
#--#-####----####----####----####----####----####----####----####---##
#-##-####-##-####-##-####-##-####-##-####-##-####-##-####-##-####-#--#
#-#--*-*--#--*-*--#--*-*--#--*-*--#--*-*--#--*-*--#--*-*--#--*-*--##-#
#-#-----#-#-----#-#-----#-#-----#-#-----#-#-----#-#-----#-#-----#-##-#
#-####-##-####-##-####-##-####-##-####-##-####-##-####-##-####-##-#--#
#-#--#-#--#--#-#--#--#-#--#--#-#--#--#-#--#--#-#--#--#-#--#--#-#--#-##
#-#-*--#-##-*--#-##-*--#-##-*--#-##-*--#-##-*--#-##-*--#-##-*--#-##--#
#-#--###*-#--###*-#--###*-#--###*-#--###*-#--###*-#--###*-#--###*-##-#
#-#-*#----#-*#----#-*#----#-*#----#-*#----#-*#----#-*#----#-*#----#--#
#-#----#--#----#--#----#--#----#--#----#--#----#--#----#--#----#--#-##
#-#--#-####--#-####--#-####--#-####--#-####--#-####--#-####--#-####--#
#-####-#---###-#---###-#---###-#---###-#---###-#---###-#---###-#---#-#
#-####--*--###--*--###--*--###--*--###--*--###--*--###--*--###--*--#-#
#-#---###-#---###-#---###-#---###-#---###-#---###-#---###-#---###-#--#
#---#-------#-------#-------#-------#-------#-------#-------#-------##
######################################################################
ID: 90737
Title: 15 Rooms
Author: Bobby